"filename", "language", "C#", "JSON", "Markdown", "XML", "comment", "blank", "total"
"/Users/dasontiovino/Documents/University/PemogramanBerorientasiObjek/UAS/hotel-backend/Controllers/AuthController.cs", "C#", 40, 0, 0, 0, 0, 9, 49
"/Users/dasontiovino/Documents/University/PemogramanBerorientasiObjek/UAS/hotel-backend/Controllers/PaymentController.cs", "C#", 72, 0, 0, 0, 2, 12, 86
"/Users/dasontiovino/Documents/University/PemogramanBerorientasiObjek/UAS/hotel-backend/Controllers/ReservationController.cs", "C#", 114, 0, 0, 0, 0, 24, 138
"/Users/dasontiovino/Documents/University/PemogramanBerorientasiObjek/UAS/hotel-backend/Controllers/RoomController.cs", "C#", 119, 0, 0, 0, 4, 18, 141
"/Users/dasontiovino/Documents/University/PemogramanBerorientasiObjek/UAS/hotel-backend/Controllers/RoomTypeController.cs", "C#", 113, 0, 0, 0, 5, 20, 138
"/Users/dasontiovino/Documents/University/PemogramanBerorientasiObjek/UAS/hotel-backend/Controllers/UserController.cs", "C#", 105, 0, 0, 0, 0, 21, 126
"/Users/dasontiovino/Documents/University/PemogramanBerorientasiObjek/UAS/hotel-backend/Data/ApplicationDbContext.cs", "C#", 49, 0, 0, 0, 10, 14, 73
"/Users/dasontiovino/Documents/University/PemogramanBerorientasiObjek/UAS/hotel-backend/Migrations/20240526044847_InitialCreate.Designer.cs", "C#", 83, 0, 0, 0, 2, 26, 111
"/Users/dasontiovino/Documents/University/PemogramanBerorientasiObjek/UAS/hotel-backend/Migrations/20240526044847_InitialCreate.cs", "C#", 69, 0, 0, 0, 3, 8, 80
"/Users/dasontiovino/Documents/University/PemogramanBerorientasiObjek/UAS/hotel-backend/Migrations/20240526053308_AddFilePathToRoomTypes.Designer.cs", "C#", 85, 0, 0, 0, 2, 27, 114
"/Users/dasontiovino/Documents/University/PemogramanBerorientasiObjek/UAS/hotel-backend/Migrations/20240526053308_AddFilePathToRoomTypes.cs", "C#", 53, 0, 0, 0, 3, 7, 63
"/Users/dasontiovino/Documents/University/PemogramanBerorientasiObjek/UAS/hotel-backend/Migrations/20240526060557_UserModel.Designer.cs", "C#", 116, 0, 0, 0, 2, 37, 155
"/Users/dasontiovino/Documents/University/PemogramanBerorientasiObjek/UAS/hotel-backend/Migrations/20240526060557_UserModel.cs", "C#", 40, 0, 0, 0, 3, 4, 47
"/Users/dasontiovino/Documents/University/PemogramanBerorientasiObjek/UAS/hotel-backend/Migrations/20240526111012_UpdateModel.Designer.cs", "C#", 180, 0, 0, 0, 2, 61, 243
"/Users/dasontiovino/Documents/University/PemogramanBerorientasiObjek/UAS/hotel-backend/Migrations/20240526111012_UpdateModel.cs", "C#", 124, 0, 0, 0, 3, 20, 147
"/Users/dasontiovino/Documents/University/PemogramanBerorientasiObjek/UAS/hotel-backend/Migrations/ApplicationDbContextModelSnapshot.cs", "C#", 178, 0, 0, 0, 1, 61, 240
"/Users/dasontiovino/Documents/University/PemogramanBerorientasiObjek/UAS/hotel-backend/Models/PaymentModel.cs", "C#", 18, 0, 0, 0, 0, 6, 24
"/Users/dasontiovino/Documents/University/PemogramanBerorientasiObjek/UAS/hotel-backend/Models/ReservationModel.cs", "C#", 28, 0, 0, 0, 0, 12, 40
"/Users/dasontiovino/Documents/University/PemogramanBerorientasiObjek/UAS/hotel-backend/Models/RoomModel.cs", "C#", 28, 0, 0, 0, 0, 7, 35
"/Users/dasontiovino/Documents/University/PemogramanBerorientasiObjek/UAS/hotel-backend/Models/RoomTypeModel.cs", "C#", 16, 0, 0, 0, 0, 7, 23
"/Users/dasontiovino/Documents/University/PemogramanBerorientasiObjek/UAS/hotel-backend/Models/UserModel.cs", "C#", 29, 0, 0, 0, 0, 9, 38
"/Users/dasontiovino/Documents/University/PemogramanBerorientasiObjek/UAS/hotel-backend/Program.cs", "C#", 28, 0, 0, 0, 3, 12, 43
"/Users/dasontiovino/Documents/University/PemogramanBerorientasiObjek/UAS/hotel-backend/Properties/launchSettings.json", "JSON", 0, 41, 0, 0, 0, 1, 42
"/Users/dasontiovino/Documents/University/PemogramanBerorientasiObjek/UAS/hotel-backend/README.md", "Markdown", 0, 0, 1, 0, 0, 1, 2
"/Users/dasontiovino/Documents/University/PemogramanBerorientasiObjek/UAS/hotel-backend/Utilities/UploadUtilities.cs", "C#", 18, 0, 0, 0, 0, 4, 22
"/Users/dasontiovino/Documents/University/PemogramanBerorientasiObjek/UAS/hotel-backend/appsettings.Development.json", "JSON", 0, 8, 0, 0, 0, 1, 9
"/Users/dasontiovino/Documents/University/PemogramanBerorientasiObjek/UAS/hotel-backend/appsettings.json", "JSON", 0, 9, 0, 0, 0, 1, 10
"/Users/dasontiovino/Documents/University/PemogramanBerorientasiObjek/UAS/hotel-backend/obj/hotel-backend.csproj.EntityFrameworkCore.targets", "XML", 0, 0, 0, 28, 0, 1, 29
"/Users/dasontiovino/Documents/University/PemogramanBerorientasiObjek/UAS/hotel-backend/obj/hotel-backend.csproj.nuget.dgspec.json", "JSON", 0, 104, 0, 0, 0, 0, 104
"/Users/dasontiovino/Documents/University/PemogramanBerorientasiObjek/UAS/hotel-backend/obj/hotel-backend.csproj.nuget.g.props", "XML", 0, 0, 0, 26, 0, 0, 26
"/Users/dasontiovino/Documents/University/PemogramanBerorientasiObjek/UAS/hotel-backend/obj/hotel-backend.csproj.nuget.g.targets", "XML", 0, 0, 0, 9, 0, 0, 9
"/Users/dasontiovino/Documents/University/PemogramanBerorientasiObjek/UAS/hotel-backend/obj/project.assets.json", "JSON", 0, 3078, 0, 0, 0, 0, 3078
"Total", "-", 1705, 3240, 1, 63, 45, 431, 5485